R 1440 800
NO  ./textures/brick.xpm 	
SO  ./textures/crate.xpm 
WE 	./textures/redbrick.xpm
EA  ./textures/greystone.xpm 

S ./textures/barrel.xpm

C 0,0,0
F 255,255,255

        11111111111111111111111111
        11111111111111111111111111
        10000000000000000000000001
        1011000222222220W200000111
        1001000000000000000000001
111111111011000001210000000000001
100000000011000001110111111111111
11110111111111011100000010001
11110111111111001101010010001111
11000000110101011100000010001
10002000000000001100000010001111
10000000000000001101010010001
11000001110101011111011110011111
11110111 1110101 101111010001
11111111 1111111 111111111111